110111011110000000-
010101010010000000-
010101010010000000-
010101010010000000-
010101010010000000-
010101010010000000-
011101110011110000-
000000000000000000